1,1,1,123,0,0,0,0,0
1,1,1,1,0,0,0,0,0
1,1,1,1,0,0,0,0,0
1,1,1,1,0,0,0,0,0
99,1,1,1,0,0,0,0,0
